NO    ./assets/path_to _the_north_texture
SO     ./assets/path_to_the_south_texture



WE	./assets/path_to_the_west _texture



EA ./assets/path_to_the_west_texture
F 163, 204, 190

C  222, 68, 5

1111
10N1
1111