NO	./path_to _the_north_texture
SO ./path_to_the_south_texture





WE ./path_to_the_west_texture
EA ./path_to_the_west_texture
F 220,100,0

C 225,30,0

         11111111 11111111111111
11111111 11111111111111111111111            
                            
11111111 1111111 11111111111   
11111111111111111111111111110  
11111111 111111111111111111111111S